질문	question
출장 (出張)	voyage d'affaire
특별하다	être special
강	fleuve
포도주	vin
숲	forêt
치마	jupe
딸	fille
차다	frapper
많다	etre nombreux
복습	révision
소개하다	se présenter
어휘	vocabulaire
스물	20
서른	30
마흔	40
쉰	50
그림	dessin
그리다 	dessiner
공화국 (共和國)	république
대화	conversation
연구원	chercheur
사업가	homme d'affaires
간호사	infirmier
소방관	pompier
건축가	architecte
예술가	artiste
작가	écrivain
은행원	banquier
변호사	avocat
약사	pharmacien
우체부	facteur
엔지니어	ingénieur
기자	journaliste
질문한개 있어요	j'ai une question
북	nord
남	sud
동	est
서	ouest
가족	famille
부모님	parents
조부모님	grands parents
손자	 petit fils
손녀	petite fille
이사 하다	déménager
실례지만, 무슨 일을 하세요?	excusez moi, quel travail exercez vous ?
성함이 어떻게 되세요?	quel est votre nom ? 성함=nom, honorifique. 되세요=devenir
저는 운동은 좋아해요	j'aime faire du sport
발사!	lancement!
서로	mutuellement, l'un avec l'autre
수업 후에, 저는 집에 가요	après l'école, je vais à la maison
어디에서 왔어요	d'où viens-tu ?
우리는/저희는 세종학당어서 한국어를 공부해요	nous étudions le coréen à Sejong hakdang.
나는 한국으로 가요/떠나요	je pars pour la Corée
따나다	partir, quitter un endroit
동작	action
잠을 자다	dormir
꿈을 꾸다	rêver un rêve
춤을 추다	danser une danse
신(발)을 신다	chausser des chaussures
낮잠을 자다	faire une sieste
늦게	tard
늦잠을 자다	faire la grasse matinée
이야기	histoire
시장	marché
장소	lieu
회사	entreprise
사장	directeur, président
도시	ville
사장님	patron
쇼핑을 하다	faire du shopping
사다	acheter
팔다	vendre
월요일	lundi
화요일	mardi
수요일	mercredi
목요일	jeudi
금요일	vendredi
토요일	samedi
일요일	dimanche
쉽다	être facile
어렵다	être difficile
서양	occident
교실	salle de classe
배우다	apprendre
가르치다	enseigner
사무실	bureau (lieu)
달리다 / 달리기를 하다	courir/faire une course (sport)
읽다	lire
저는 검퓨터를 (하는것을/하기를) 좋아해요	j'aime utiliser l'ordinateur
요리를 하다	cuisiner
미식가	gourmet
대식가	gourmand / qui mange beaucoup
여러분	vous tous
배고프다	avoir faim (lit. le ventre vide)
부르다 / 배(가)불러요	être rassasié / ne plus avoir faim
질문	question
전화	téléphone
맞는 답에	la bonne réponse
친절하다 	être gentil (adj)
착하다	avoir bon coeur
장소	lieu
회사	entreprise
연세	âge, honorifique (나이 sinon)
연세가 어떻게 되세요?	quel âge avez-vous ?
실례지만 이름이 어떻게 되세요?	excusez-moi, quel est votre nom ?
오늘은 몇칠 이에요?	quel jour (de l'année) sommes nous aujourd'hui ?
위치	position, localisation
책상	bureau
책장	armoire, bibliothèque
밥상	table à manger (familier) = 식탁
책방, 서점	librairie
도서관	bibliothèque
공책 (空冊)	cahier
볼펜	stylo bille
연필	crayon papier
앞	devant
뒤	derrière
옆	à côté
안	à l'intérieur
밖	à l'extérieur
위	sur
아래/밑	en dessous
가운데	au milieu
근처	aux alentours de (littéraire)
사이	entre
돈	argent
정말	beaucoup, vraiment
종말	fin du monde
맛있게 (드세요/먹으세요)	bon appetit
잘 먹겠습니다	je vais bien manger (réponse à bon appétit)
저는 x 하고 y 사이에 있어요	je suis entre x et y
침대	lit
오늘은 날씨가 어때요? 흐려요 하지만 따뜻해요	il fait quel temps aujourd'hui ? il fait gris mais chaud (tiède)
맑아요	le ciel est clair
쌀쌀하다	faire froid/frisquet
쉬다	se reposer
낮 12시 / 정오	midi
밤 12시/자정	minuit
시작하다	commencer
수영 하다	nager
새벽	aube
새벽 두 시에	à 2h du matin
매일	tous les jours
벽	mur
사고	accident
동료	collègue
배	bateau, ventre, poire
정의 (正義)	justice
슬프다	être triste
기쁘다	être joyeux
놀라다	être surpris
우울하다	être déprimé
울다	pleurer
두렵다	craindre
술집	bar
침실	chambre (plus précis que 방)
처음	commencement
모두 다	tout le monde
학원	institut privé
박물관	musée
권	classificateur des livres
고양이	chat
탁자	petite table
젓가락	baguettes
포크	fourchette
모습	apparence
수영장	piscine
외투, 코트	manteau
중간	au milieu
명함	carte de visite
시험을 보다 (試驗)	passer un test
받다	recevoir
주다	donner
받아 쓰기	dictée
번역	traduction
작문	rédaction
어휘	vocabulaire
저녁 식사	repas du soir
간식	goûter (repas)
밤참	en-cas (soir)
방법	manière, façon
요리법	recette de cuisine
서로 인사 하고 있어요	nous sommes en train de nous saluer
 악수 하다	se serrer la main
다르다	être différents (conj: 달라요)
모르다	ne pas savoir (conj : 몰라요)
주말	weekend
주중	en semaine
주부	femme au foyer
쌍둥이	jumeau
외동딸	fille unique
외아들	fils unique
아르바이트를 하다	travailler à temps partiel
칠판	tableau
달력	calendrier
스탠드	lampe
벽	mur
벽장	placard
쓰레기통	poubelle (boîte à déchets 쓰레)
필통	trousse
옷걸이	porte-manteau
서랍	tiroirs
화장실	toilettes
난방기	radiateur
정리하다	ranger
장난감	jouets
알람시계	réveil
손목시계	montre bracelet
벽시계	horloge sur le mur
오랜만 이에요	ça fait longtemps ! (formule de salutation)
행복	bonheur
어서 오세요!	bienvenue (formule figée)
맛있게 드십시어	mangez ! (impératif)
숫자	chiffres
일억	100 Millions
십억	1 G (1000 millions)
일조	1000G (1000 milliards)
새해복 많이 받으세요	bonne année (recevez beaucoup de chance pour la nouvelle année)
한국어를 사용하다	사용하다 utiliser. utiliser la langue coréenne
양력	calendrier solaire
음력	calendrier lunaire
설날	fête du nouvel an
음료수	boisson
고추	piment
피망	poivron
개	classificateur général
명	classificateur des personnes 
마리	classificateur des animaux
생선	poisson (생선 1마리 주세요)
권	classificateur des livres
물고기	poisson
생선 가게	poissonnerie
소설	roman
만화책	manga
깎다	baisser (prix), tailler
겸손	modestie
가격	prix
가격이 얼마예요?	quel est le prix ?
셔츠	chemise
짜리	valeur : 오천원짜리 지폐 (nom valeur : 가치)
비행기	avion
손님	client, invité
점원	vendeur (dans un magasin)
대통령	président
바구니	panier
가지다	avoir, posséder
영하1 도	-1°C
자주	souvent
들다	tenir
죄송합니다	présenter ses excuses
동물	animal
드리다	donner (honorifique)
R-ㄹ까요	demander l'avis (ex. 뭐 드릴까요?)
아저씨	homme (syn 남자, 남성)
아주마니	femme (syn 여자, 여성)
아가씨	demoiselle
정답	bonne réponse
되다	devenir
아직	encore (devant verbe)
비가 오다	pleuvoir
불다	souffler
바람	vent
묻다	demander
걷다	marcher
싣다	charger (qn) / entreposer, mettre
대	classificateur des objets électriques
그리고 / R-고	et
그러나 / R-(으)나	mais
그렇지만, 그렇지만 / R-지만	oui mais (attenué)
그래서 / R-니까	donc/plus
그러니까	donc/plus (plus justifié)
그래도 / R-아/어 도 / 그럼에도 불구하고	malgré cela
그러면 / R-(으)면	dans ce cas / condition
그러면(서) / R-(으)면(서)	en même temps / simultanéité
그런데 / R-는데 (verbe) / R-(으)ㄴ데 (adj)	en fait, par ailleurs, donc...
오른쪽	à droite
왼쪽	à gauche
똑바로	tout droit
찾다	chercher
건강 하세요	soyez en bonne santé !
행복 하세요	soyez heureux
돈 많이 버세요	gagnez beaucoup d'argent (벌다 gagner)
바라다	espérer
평화	paix
결심	résolution
성공	réussite
불	feu
부자	riche
웃다	sourire
드시다	manger (hon.)
계시다	avoir (hon.)
정치학	politique
사회학	sociologie
선물	cadeau
회의	réunion (travail)
일과	ce que vous avez fait
하루 (24h)	un jour
주말	week-end
mois	달
année	해 / 년
그제	avant hier
après demain	모레
고르다	choisir
모르다	ne pas savoir
혼자	tout seul
홍차	thé noir
대사	ambassadeur
대사관	ambassade
편의점	magasin ouvert 24h/24
술집	bar
놀다	s'amuser
활동	activité
산책하다	se promener
낚시하다	pêcher
유학을 가다	étudier à l'étranger
이사 가다	déménager
6년 전부터	depuis 6 ans
지난해 / 작년	l'an dernier
올해 / 이번년 / 금년	cette année
더/덜 매운 ...	plus/moins épicé
여행	voyage
(시간이)걸리다	prendre du temps
까지	jusque
부터	à partir de
2월초	au début de février (milieu 중순, fin 말)
시험지	feuille d'examen
켤레	classificateur des paires
양말	chaussettes
신발	chaussures
잔치	fête
한잔하다	prendre un verre
즐기다	prendre plaisir à (adverbe 즐겨)
식사를 하다	prendre un repas
산책 하다	se promener
지하철	métro
자전거	vélo
걸어서	en marchant (걷다 marcher)
뛰어서	en courant
날아서	en volant
맞다 / 틀리다	être vrai / faux
화폐	monnaie
R-(으)ㄴ 적이있다 (없다)	expérience, avoir fait R par le passé
R-(으)ㄹ 까요	demander l'avis de quelqu'un sur R. ~ qu'en penses-tu, à ton avis
지폐	billet
동전	pièce
R-(으)ㄹ 때	au moment où, lorsque
R-는 N	proposition relative (R) au présent
N-에 대해	à propos de N
R-아/어 보다	essayer de faire quelque chose
알아보다	essayer de savoir, se renseigner
어치	expression de la quantité - 오만원 어치 사과를 주세요
현금	argent liquide (espèces)
신용 카드	carte de crédit
Na-뿐만 아니라... Nb-도	non seulement Na, mais aussi Nb (Na et Nb implicitement COD)
R-아/어서	exprime la manière / cause / suite
Na-(이)나 Nb	a ou b (choix)
Na-(이)나 Nb 동	a, b, etc.
R-(으)ㄹ 수있다	pouvoir faire. expression auxiliaire pouvoir infinitive
며칠동안	pendant combien de jours (temps)
당구장 (撞球場)	billard
볼링장	bowling
길다	être long (adjectif 긴)
짧다	être court (adj 짧은)
출근하다	aller au travail
옷걸이	porte-manteau, cintre
자판기	machine à café
과자	snack
어떤 장르	quel genre
일주일	une semaine
한명씩	chaque personne
감자칩	chips
계산하다 / 돈을 내다	régler, payer
낫다	guérir
봄	printemps
가을	automne
여름	été
겨울	hiver
관광지	lieux touristiques
관광하다	faire du tourisme
꽃	fleur
꼬치	brochette
왜냐 하면	parce que
R-아/어 지다	indique un changement d'état. ex : 날씨가 좋아졌어요
실력	capacité, compétence (한국어 실력)
N-덕분에	grâce à
N-때문에	à cause de
벚꽃	fleurs de cerisier
꽃이 피다	fleurir, pousser
즐겁다	être joyeux
괴롭게	ne pas être joyeux
물놀이	jeux dans l'eau
단풍	feuilles colorées (automne)
단풍	érable
은행 나무	ginkgo
쌓다 ; 쌓이다	s'empiler (neige); être empilé
바캉스 /휴가	vacances
계절	saison
제일	le plus
스키를 타다	faire du ski
눈사람	bonhomme de neige
시금치	épinards
싸우다	se battre, disputer
것	chose
덥다	faire chaud
춥다	faire froid
밉다	être détestable (personne)
따뜻하다	faire doux
시원하다	faire frais
해가 나요	il y a du soleil (해 soleil)
에어컨	climatisation
얼음	glaçons
부채	éventail
선풍기	ventilateur
성격	caractère
R-지 않다	négation
민주화 운동	mouvement démocratique
탄생하다, 태어나다	naître
멀다	être loin
가깝다	être proche
말을 놓다	se tutoyer
동갑	même âge
파리 여행이 몇 번 째예요?	c'est la combientième fois que tu viens à Paris ?
무용	danse
미술	art plastique
전통 예술	art traditionnel
구름	nuage
하늘	ciel
하늘이 흐려요	le ciel est gris
가볍다 / 무겁다	léger / lourd
모자를 쓰다	porter un chapeau
방지 / 장갑을 꼈어요 (끼다)	porter un anneau, des gants
목도리를 매다	porter une écharpe
하얗다	être blanc
요즘	ces derniers temps, en ce moment
추워서 몸을 떨고있어요	à cause du froid, mon corps tremble
시원한옷	vêtements frais
따뜻한 옷	vêtements chauds	
우산을 쓰고있어요	je porte un parapluie
선풍기를 사용하다	utiliser un ventilateur
땀	sueur
흘리다	couler
부채	éventail
부채질을 해요	j'utilise un éventail
답장	réponse
삭제	supprimer
보내다	envoyer
골뱅이	@ / bulot
달팽이	escargot
제목	sujet
두꺼운옷	vêtements épais
두껍다 / 얇다	épais / mince
메일	mail
포근하다	être agréable, chaud (vêtement)
그렇죠	n'est-ce pas ?
미용실/미용원	salon de coiffure
머리카라	cheveux
긴 머리를 가진 여자	fille aux cheveux longs
잦다, 가지다	avoir
코	nez
눈	oeil
입	bouche
입술	lèvres
귀	oreilles
목	cou
팔	bras
손	main
손목	poignet
발	pied
다리	jambes
손가락 / 발가락	doigts de mains / de pieds
신발 치수	pointure
제외 / 빼고 (fam)	sauf
주말을 제외 하고	sauf le weekend
낮다 / 깊다	peu profond / profond
동요	comptine
높다	être haut
비행기	avion
R-나서	indique la suite
미리	en avance
예약하다	reserver
태어난날	jour de naissance
지하철 번호	numéro de métro
날짜	date
시작	début
불금 (불타는 금요일)	vendredi (expression)
몇시에 집에 가요?	à quelle heure rentres-tu à la maison ?
어제 / 어저게	hier
꽃피는 계절	saison des fleurs (~mai)
돌아오다	revenir (돌 : retourner)
N-마다	chaque N
얼굴	visage
점심때	au moment du déjeuner
6시 10분 전이에요	il est 6 heures moins 10
폭력	violence
폭력 적이다	être violent
강등	conflit
눈치	6e sens
빠르다	être rapide
퇴근 하다	quitter le travail
양파	oignon
운동장	gymnase
계획	projet
뭐 타고와요?	par quel moyen de transport viens-tu?
x 을/를 위해서	pour x
잘 생기다	"être beau, ""bien paraitre"" (homme). contraire 못 ~. utilisé au passé."
어떠하다	être comment
선약이 있다	avoir un rendez-vous
내용 (약속의내용)	contenu (d'un rendez-vous)
버섯	champignon
당근	carottes
마늘	ail
인삼	ginseng
달걀	oeuf
콩나물	soja
양배추	choux
감자	pomme de terre
할인	remise (vente)
극장	salle de cinéma
백화점	grand magasin
휴일	jour férié
푹자다	bien dormir
10시간 동안	pendant 10h
한번	une fois (cardinal)
일번	1e fois
전혀	jamais
야채 / 채소	légumes
R-아/어 야 하다	falloir faire qqch
제안 하다	proposer qqch à qn
약속 하다	prendre rendez-vous
약속 시간/정소를 정 하다	fixer l'heure/le lieu d'un rendez-vous
마지막 학기	dernier trimestre
시간이 되요	être disponible
R-(으)ㄹ 래요 ?/.	demander/affirmer l'opinion, la volonté, l'intention
R-(으)ㄹ 게요.	déclarer l'intention
R-(으)ㅂ시다, R-(으)십시다	impératif formel poli (proposition)
잘 모르겠어요	je ne sais pas bien
기차역 / 지하철역	gare de train/métro
축제	festival
소풍을 가다	faire un pique nique
썬텐 하다 / 햇볕을 쬐다 / 일광욕을 하다	prendre le soleil
계곡	rivière, torrent
단감	kaki (fruit)
책자	brochure
작년 / 지난 해	l'année dernière
다음해 / 내년	l'an prochain
사진을 찍다	prendre une photo
고궁	palais ancien
해변	plage
방문 하다	visiter
등산 하다	randonner
공놀이	jeux de ballon
문화	culture
감상 하다	admirer
구경 하다	regarder avec attention
이빨 / 치아	dent
치과의사	dentiste
오후 내내	tout l'après midi
하루종일	toute la journée
어린 왕자	le petit prince
도장을 찍다	signer avec un sceau
현재	présent
과거	passé
미래	futur
연극	pièce de théâtre
축구	football
마시고 축자!	buvons jusqu'à la mort (expression)
R-(으)ㅂ 시다	proposition (radical)
공항	aéroport
방학	vacances scolaires
숟가락	cuillère
같다	être pareil
곳	lieu, après une forme déterminante
그리고나서	ensuite
전자 우편	courrier électronique
야유회, 야유에 가다	pique nique (sortir s'amuser ensemble)
역사 (歷史)	Histoire
관심이 있다	avoir de l'intérêt
경치	paysage
자연	nature
R-아/어 보다	avoir déjà fait, avoir l'expérience
가끔	parfois
어떨때는	des fois
준비 하다	préparer
출발 하다	commencer, partir
도착 하다	arriver, partir
웃기다	être drôle
R-지요?	n'est-ce pas ? au passé, après verbe d'action ou description
재미없다 = 지루하다	ennuyeux
주사위	dé (jeu)
단지다	lancer (dé)
만큼	autant que
다른	autre (personne)
국적	nationalité
음악회에 가다	aller à un concert
안벽 등반 (岸壁 登攀)	escalade
N-이유	raison pour laquelle... (déterminant)
파업	grève
배우	acteur
잊어버렸어요	j'ai oublié
경제	économie
과학	sciences
송이	classificateur des plantes à tige (raisin, banane, fleurs...)
치즈	fromage
10유로 쯤	environ 10€
주제	sujet
생활	vie
말하기 대해	concours de discours
군대	classificateur des lieux
공연	spectacle
해변	plage
회	poisson cru
다른 것을	d'autres choses
미녀	beauté
괴롭다	être angoissé
찜질방	sauna
감독	réalisateur
유명 하다	être célèbre
무료	gratuit
R-(으)면 안돼요	interdiction
앞으로	dans le futur
자신 	soi-même
페인트를 칠하다	peindre (mur)
배를 조종하다	naviguer (voyager en bateau)
배로 한해하다	naviguer, conduire un bateau
대학교	université
대학원	école (master, doctorat)
졸업을 하다	être diplômé
열심히	ardemment
남미	Amérique du sud
R-아/어 야하다	devoir faire quelque chose
특이 하다	être excentrique, insolite
다양성	diversifié
감동적이다	être touchant
행사가있다	événement spécial
액자	cadre (photo)
벌	classificateur des vêtements
그루	classificateur des arbres
신발을 신다	porter des chaussures
나비 넥타이	nœud papillon
운동화	baskets (chaussures)
파란색	bleu
빨간색	rouge
청바지	blue jeans
흰색	blanc
검은색	noir
초록색 / 녹색	vert
노란색	jaune
회색	gris
보라색	violet
핑크색 / 분홍색	rose (couleur)
갈색 / 밤색	marron
원피스	robe
샌들	sandales
차다	porter une montre, un bracelet
가져가다	apporter
내려가다	descendre
올라가다	monter
불타다	être brûlé
abeille	벌
안부, 소식	nouvelles de qn
대중교통	transports en commun
외모	apparence
모임	réunion, événement entre amis
옷차림	tenue
기분과 감정	humeur et emotions
졸리다 / 졸다	avoir en de dormir (suj=soi) / somnoler, piquer du nez, involontairement (suj=autre personne)
수습교원	stagiaire
차례	sommaire
불친절하다	ne pas être gentil
편리하다	être confortable, pratique (déplacement)
R-께	datif de respect
그럭저럭, 그저 그렇다	comme ci comme ça
시간이 있다, 한가하다	avoir du temps libre
시차 = 시간 차이	décalage horaire
전신이 없다	être étourdi, distrait, déconcentré
정신을 잃다 / 정신 잃어 버리다	perdre la tête
R-다(가) Action2	interruption de l'action R par action2 / changement graduel
학교에 갔다가 영화관에 갔어요	j'étais en chemin vers l'école, mais je suis allé au cinéma (interruption)
세일	soldes
수리하다	nettoyer, réparer
걸리다	être accroché
구	arrondissement
시청	mairie de ville
구청	mairie d'arrondissement
농악	musique traditionnelle paysanne
부채춤	danse, avec un eventail
연꽃	fleur de lotus
장구	tambour (portable)
한과	gâteaux traditionnels
서예	calligraphie
종이 점기	pliage de papier
매듭	noeuds
다식 만들기	gâteaux de thé
켜다, 끄다	allumer, éteindre
켜지다, 꺼지다	être allumé, être éteint
한강을 따라서	en suivant le fleuve Han
문자 (메시지)	texto
R-(으)시오, R-(으)십시오	ordre, souhait formel poli
빈도	fréquence
항상/언제나/늘	toujours
pas tellement (phrases négatives)	별로
거의	presque pas
7유로 대신에 5유로 내면 돼요	lit. il est autorisé de payer 5€ au lieu de 7€
할수 없어요/못해요/할줄 몰라요	négation d'incapacité
R-(으)ㄹ 줄 알다/모르다	proposition savoir infinitive
누구나	tout le monde
무엇이나	toutes les choses
어디나	partout
동그라미, 동그랗다	cercle, être rond
가위표	croix (marque des ciseaux)
모이다	se rassembler
꼭	absolument, sans faute, vraiment
곡	partition
R-(으)ㅁ	nominalisation, pour le résultat d'une action
금발 (머리)	blond
갈색 머리	brun
흑맥주	bière noire (guiness)
비비다 / 비빔	mélanger / mélange
짜장면	plat de nouilles noires
짬뽕	plat de nouilles et fruits de mer, très épicé
배달	livraison
삼계탕	soupe poulet ginseng
군만두	만두 grillé
찐만두	raviolis cuits à la vapeur
삼겹살	bbq poitrine de porc. 3/couches/chair
싱겁다	manquer de sel, être fade
달다	être sucré
쓰다	être amer
시다	être acide
공상	imagination, rêve
건강에 좋다/나쁘다	être bon/mauvais pour la santé
N-중에(서)	parmi
뼈해장국	soupe d'os, piquant
드겁다 / 차갑다	être chaud/froid (objet)
음식을 주문하다/시키다	commander un plat
해물	fruits de mer
길거리 음식	street food
배고파 죽겠어요	je meurs de faim
참치	thon
(음식) 재료	ingrédients
단무지	radis jaune
부치다	griller
볶다	griller, frire, rôtir
굽다	griller (viande)
끓다	bouillir
자르다	couper
짭짤하다	être salé, mais bon
고소하다	avoir le bon goût d'huile de sesame
한가하다	avoir du temps libre
계속	continuellement, sans arrêt
영화비평	critique de cinéma (acte, article)
정원을 가꾸다/돌보다	s'occuper du jardin
회의에 참석하다	participer à une réunion
명절	fête traditionnelle
미역	algue (plus grand que 김, couleur différente)
막히다	être bloqué (trafic)
걸다 / 걸리다	accrocher / être accroché, prendre du temps
이용	utilisation
하루 / 이틀 / 사흘	1 jour / 2j / 3j
항구	port
트럭	camion
오토바이	moto
입이 아파요	expression, je ne veux pas répéter ce que je viens de dire
느리다, 느리게	être lent, lentement
영수증 (領收證)	addition
거스름돈	monnaie rendue
현상 하다	développer des photos
보정하다	retoucher des photos
고소 공포즘 있다	avoir le vertige
하품 / 하품이 나다	baillement / bailler
대표 음식	plat représentatif
콧물	mucus nasal
기침	toux
예절	étiquette (protocole)
별 문제가 없어요	il n'y a pas de problème particulier
기념식	cérémonie de commémoration
기도	prière
인내심	patience
장식품	objet décoratif
줄을 몪다	nouer, lier
성당	église catholique
연주하다	jouer d'un instrument de musique
비교하다	comparer
궁 / 궁궐 / 궁전	palais / palais coréen / palais étranger
동상	statue
옮기다	déplacer quelque chose (objet, capitale)
탈춤	danse au masque
박수를 치다	applaudir
우아하다	être élégant
독창적이다	être original
소리를 날카롭다	avoir une voix aiguë
태권도 시범	démonstration de taekwondo
갈아타다, 바꿔타다	changer de moyen de transport
번 / 호 (1번 버스, 1호실)	classificateur des objets numérotés (ligne de bus, chambre d'hôtel)
기다 / 기어올라가다	grimper, marcher à 4 pattes / monter en grimpant
먼저 / 우선 / 일단	d'abord
오십분에서 오십오분	50~55 minutes
비용	frais (nourriture)
5번 출구 옆	à côté de la sortie numéro 5
출구 / 입구 / 출입구	entrée / sortie / entrée-sortie
교통 수단	moyen de transport
국제적인	international
상업	commerce
자라다	grandir
길 찾기/묻기	chercher, demander son chemin
동쪽, 서쪽, 남쪽, 복쪽	est, ouest, sud, nord
행인	personne qui passe, passant
이 쪽으로 쭉 가세요	continuez de ce côté
복도 (複道)	couloir
안내 데스크	accueil
전차, 드람, 드램	tramway
확실하다	être sur, certain
조만간에	tôt ou tard
큰 변화	grands changements
경제적인 준비	préparations économiques
겸 / 욕실겸 화잔실	en même temps / salle de bains-wc
노안/젊은 이	proportions de personnes âgées / jeunes
인구	population
줄다 / 줄이다	diminuer passif/actif
인구가 늙어가고 있다	la population est en train de vieillir
경멸하다	mépriser (péjoratif)
좋은 점수를 받다	recevoir de bonnes notes
사이 / 관계	relation
세우다	établir (projet)
늘리다	augmenter, accroitre (actif)
차가 밀리다	"""la voiture est poussée"", il y a des bouchons"
소포	colis
소포를/편지를 부치다	envoyer un colis, une lettre
강의실	salle de classe à l'université
돌다, 꺾다	tourner
이동	déplacement
유턴 하다	faire demi tour
깨다	se réveiller 
학교에/학교로 가다가 친구를 만났어요	j'allais à l'école quand j'ai rencontré un ami
정류장	arrêt de bus
 사거리	carrefour
회단 보도	passage piéton 
횡단 하다/건너다	traverser (piéton)
가는/오는 법	manière d'aller / venir
가는법이 어떻게 돼요?	comment peut on y aller?
가리키다	indiquer une direction, montrer, désigner 
10분쯤, 10분정도	environ 10 minutes
동 / 회 / 층	classificateurs : numéro d'immeuble, d'appartement, d'étage 
(만약에).... (으)면 ...	si
오르는길 / 내리는길	rue qui monte / descend
인어	sirène 
칠면조	dinde
훈제 연어	saumon fumé
생굴	huître
선물을 주고 받는 계절	saison des cadeaux
잚다	être jeune
N을/를 위해서 // R기 위해서	pour
R-아/어 주다	rendre un service
빌리다	emprunter
빌려주다	prêter 
N-에게, N-한테 / N-께	datif / datif de respect
잘 못 걸었어요, 잘 못 거셨어요	je me suis trompé de numéro 
R-은데요	"suffixe de contextualisation : exprime une attente, hésitation. ~""en fait"""
통화 중입니다	la personne est en conversation / la ligne est occupée (2 sens possibles)
실례지만 어디세요?	"excusez moi, ""où mon appel est-il arrivé"" (qui est au bout du fil)"
R-지요	terminaison de soulignement : c'est bien, n'est ce pas
들어 가세요 (tel) / 이만 끊을게요	au revoir (au téléphone)
댁	maison (hon.)
물론이지요, 그럼요	oui, évidemment 
나이를 먹다	prendre un an d'âge 
휴대폰, 휴대전화, 핸드폰, 스마트폰	smartphone 
참석하다	assister à une réunion, cérémonie 
결혼식	cérémonie de mariage
일전을 확인할 수 있어요	on peut vérifier son planning
내려받다	télécharger
메시지를 남겨 주시면, 나중에 다시 전화하겠습니다	si vous laissez un message, je vous rappellerai plus tard
종업원	serveur
분위기 	atmosphère
추천하다	recommander
R-(으)면 되다	permission : ~si vous faites R, ça ira 
버스를 놓치다	rater un bus
기회를 놓치다	rater une occasion
조사	enquête 
만족도	satisfaction 
학습자	éducation 
의견 (意見)	avis, opinion
덕담을 나누다	partager des voeux
말을 걸다	adresser la parole à quelqu'un 
음성 메시지를 남기다	laisser un message vocal
R-(으)ㄴ 지 / R-는지	introduit une proposition interrogative indirecte. pour les adjectifs ou 이다 / pour les verbes au présent
전화번호가 몇 번 인지 가르쳐 주세요 	enseignez moi quel est votre numéro de téléphone
전화번호가 몇번 인지 말씀해 주세요	dites moi quel est votre numéro de téléphone
지금 비가 오는지, 안오는지 알고 싶어요	je veux savoir si il pleut
다시 한번 천천히 말씀해 주세요	répétez encore une fois lentement
가위, 바위, 보 / 찌, 묵, 빠	ciseaux, pierre, feuille
R-다고 말하다	suffixe de citation, phrases declaratives
R-이라고 말하다	suffixe de citation, avec 이다
R-냐고 묻다/물어보다	suffixe de citation, phrases interrogatives
R-(으)라고 말하다	suffixe de citation, phrases impératives, ordre, demande, conseil
R-자고 말하다	suffixe de citation, propositions
나중에 디시 전화하겠다고 전해 주세요	dites moi si vous voulez que je rappelle plus tard
구워서 먹다	manger en grillant
갈비 구이/꼬치 구이	brochette grillée 
지금 수업 중이에요? 지금 수업하는 중이에요? 지금 수업을 하고있어요?	es-tu en cours maintenant?
투이 씨가 지금 공부를 할건지, 안할건지 몰라요	je ne sais pas si Thui va travailler ou non (interrogative au futur)
택시를 잡기 위해 손을 들고 있는 사람	les gens qui lèvent la main pour appeler un taxi
안전문이 설치된 지하철역 	station de métro équipée de portes de sécurité 
지하철 내부	intérieur du métro 
겉모습	apparence extérieure 
얼굴 생김새	forme du visage
몸매	ligne, silhouette
성형 수술	opération de chirurgie esthétique
차리다	se préparer, se parer
바지	pantalon
티셔츠	T-shirt
블라우스	chemisier
멋있다	être élégant
하이힐	talons hauts
설명하다	expliquer
날씬하다	être mince
마르다 (irr: 말랐어요)	être maigre, sec
가방을 들다	porter un sac à la main
배낭을 매다	porter un sac à dos
벗다	enlever un vêtement
N-(으)ㄴ	forme déterminante intemporelle
반친구	amis de classe
마음속으로	dans votre tête
맞히다	deviner, trouver
머리도 길지도 않고 짧지도 않아요	avoir les cheveux mi longs
늘씬 하다	être élancé
목이 말라요	j'ai soif
통통하다	être dodu (ex. pour les bébés)
퉁퉁하다, 배가 나왔어요	être gros
가방을 놓다	poser un sac
스웨터	pull over
푸른	bleu foncé
녹색	vert
연두색	vert clair
초록색 	vert clair
후추	poivre
밤색 (머리)	cheveux chatain
적색 (머리)	cheveux roux
흰색 (머리)	cheveux blancs
회색 (머리)	cheveux gris
R-(으)ㄴ 편이다	être plutôt...
이상형, 타이프, 스타일	type, style
연예인	personne connue
날마다 달라요	c'est différent tous les jours
가출 하다	fuguer
발달 / 발달 하다 / 발달 되다	développement
어디든	n'importe où
R-아/어 있다	exprime un état
문이 닫혀 있어요	la porte reste fermée  (état)
닫히다	être fermé
일반적인	en général  (forme déterminante)
고속철	chemin de fer à grande vitesse
먼 거리	longue distance
근처 도시	villes proches
깨끗하다	être propre
이 가족은 행복한 것 같아요	cette famille a l'air heureuse
R-(으)ㄴ 것 같아요	sembler que
늙다	être âgé
젊어보여요	il semble jeune (pour un adulte)
젊다 / 어린다	être jeune / jeune pour un enfant
노인, 어르신	personnes âgées
나이보다	faire plus vieux que son âge
내가 우주인이 된다면	si j'étais devenu astronaute...
이촌 / 삼촌 / 사촌	parents (2e degré) / oncle (3e) / cousin (4e)
고모	tante paternelle
아주머니	tante, en général
자매	soeurs
나매	frères et soeurs (on sait qu'il y a les 2)
형제	frères et soeurs (on ne sait pas s'il y a les 2)
치과	 cabinet de dentiste
치약	dentifrice
칫솔	brosse à dents
치실	fil dentaire
치통	mal de dents
생김새/외모/겉모습	apparence
결혼 반지	bague de mariage
약혼 반지	bague de fiançailles
벨트 / 혁대	ceinture
고고학자	archéologue
우주인	astronaute
나타낸다 / 나타내다	faire paraître / paraître
소유	possession
돌아가시다, 축다	mourir
세상을 떠나다	quitter le monde, décéder 
살아 있다 / 계시다	être vivant
편찮으시다 / 아프다	être malade 
같이/따로 살다	habiter ensemble / séparément
가깝지도 않고, 멀지도 않아요	ce n'est ni proche ni loin
차이점	différences
무릎을 끓고 앉아서	à genoux
드라이브를 하다	se promener en voiture
가정부	femme de ménage
은퇴하다	être à la retraite
외출 하다 = 밖에 나가다	sortir
교통 사고	accident de la route
불/자동차/사람 조심	attention au feu/aux voitures/aux gens
해외 여행	voyage au-delà de la mer (overseas)
관광 여행	voyage touristique
수학 여행	voyage scolaire
비자	visa
짐을 싸다	préparer, mettre des choses dans sa valise
신혼 여행	voyage de noces
숙소	logement
여권	passeport
수수료	commission de change
환율	taux de change
외국인 카드	carte de résident étranger
환전하다, (한국돈으로) 돈을 바꾸다	changer de l'argent
환전소	bureau de change
R (으)려고 하다	expression de l'intention de faire quelque chose
이번 여름에 무엇을 하려고 해요?	qu'as tu l'intention de faire cet été ?
여행지	lieu de voyage
특징	caractéristiques
유명한 화가	peintre célèbre 
화산	volcan
향수	parfum/nostalgie
공기가 맑다	l'air est pur
친절하다	être gentil
교통이 편리하다	les transports sont confortables
넣다	mettre quelque chose dans quelque chose 
염전	marais salant
얻다	obtenir
소금 사막	 désert de sel
아름다운 경치	un beau paysage
튀기다 / 감자 튀김	faire frire / pommes de terre frites
동문	zoo
사원	temple boudhiste
석사	master (études)
연수	stagiaire
동양	orient
언어	 langue
밤 경치 = 야경	paysage nocturne
시골	campagne
사람에 따라 달라요	ca dépend des gens
섬	île
호수	lac
온천	source thermale
폭포	cascade
유적지	lieu archéologique
민속촌	village folklorique
드라마 촬영지	lieu de tournage de drama
놀이공원	parc d'attraction
검사/판사	juge
기차, 배, 점심 제공/포함	offre avec train, bateau, déjeuner inclus
세모, 삼각형 / 세모나다	triangle / être triangulaire
무료, 공짜 / 유료	gratuit / payant
장식	décoration
수도	capitale, eau courante
후원, 비원 (비밀의 정원)	jardin arrière
용암동굴	grotte de lave
기사	article (journal)
실제 사람,실제 상황	personnes réelles, situations réelles 
몸/신체	corps
신체 부인	partie du corps
콧물이 나다	avoir le nez qui coule
코를 풀다	se moucher
코를 흘쩍이다	renifler
속눈썹	cils
왼순잡이, 오른손잡이	droitier, gaucher
양손잡이	ambidextre
건강 상태	état de santé
꼬르륵 꼬르륵	gargouillement (onomatopée)
다치다	se blesser
독감	grippe
조류 독감	grippe aviaire
병에 걸리다	attraper une maladie
열이 나다	avoir de la fièvre
기침을 하다	tousser
재채기 하다	éternuer
몸이 떨리다, 오한이 나다	frissonner
R-(으)ㄴ 후에 / R-후에	après...
R-기 전에 / N-전에	avant...
기지개 / 기지개를 펴다	étirements / s'étirer
취직을 하다	trouver un travail, être embauché
안색 / 안색이 안 좋아요	couleur du visage / tu n'as pas bonne mine
안과의사 (眼科醫師)	ophtalmologue
주황색	 orange (couleur)
남색	bleu foncé
쥐색	gris foncé
태양	soleil
뾰족하다	être pointu
사각형, 네모 / 네모나다	rectangle / être rectangulaire
N-모양	en forme de...
별 모양, 하트 모양, 구름 모양...	en forme d'étoile, de coeur, de nuage...
N-무늬	motif à ...
줄무늬	motif à rayures
꽃무늬	motif à fleurs
물방울 무늬	motif à pois (gouttes)
민무늬	sans motif
얼룩 무늬	motif avec des taches
표범무늬	motif léopard
채크 무늬	motif à carreaux
짙은/연한 + couleur	plus foncé / plus clair
면바지	pantalon en coton
복장	tenue
스타킹	collants
화장하다	se maquiller
화장품	produits de maquillage
구두하고 같은 색깔의 스웨터 입었어요	il porte un pull de la même couleur que ses chaussures
정등(불)	lampe à pied (ex. halogène)
낮은 부츠	bottines
혀	langue
깃발	drapeau
굴뚝	cheminée
울타리	barrière
창문	fenêtre
리본	ruban
깨어있다	être éveillé
인형	poupée, peluche
손잡	poignée  (sac)
가방끈	bretelle de sac
신랑 / 신부	marié / mariée
신혼 부부	nouveau couple
대표적인	représentatif
국립공원 [궁닙]	parc national
해수욕 하다	se baigner dans la mer
전체	entier
왕	roi
무덤	tombeau
천문대	observatoire
언덕	colline
증상	symptômes
조언	conseil utile
R-지말다	"impératif, ""arrêtez de"""
이가 상하다	pourrir  (dent)
유행	mode
의상 (衣裳)	habits, pour un spectacle ou un film
정치인	politicien
개봉하다	sortir (film)
찻집	salon de thé
도둑	voleur
예술 작품	oeuvre d'art
직진하다	conduire tout droit
운전사	conducteur
무단하다	traverser au rouge (piéton)
고장이 나다	tomber en panne
N-말고	expression du contraire (N)
청첩장	invitation pour un mariage
어깨가 무겁다	avoir des soucis
반대말	le contraire
머리가 깨질 것 같아요	se casser la tête (expression)
짜증 나다	être en colère
차별하다	discriminer
단순하다	être simple
언제 갈 예정이에요? R-(으)ㄹ  예정	quand est-ce prévu d'y aller ?
학비	frais de scolarité
예의 (禮儀) / 예의가 없어요	politesse / ce n'est pas poli
허락을 받다	recevoir l'approbation, autorisation
평균 월급	salaire mensuel moyen
집세	loyer
자막	sous-titre
교외, 시외	banlieue
파면되다	être destitué
타핵되다	to be impeached / mis en accusation 
선거	élection
후보	candidat
소화제	médicaments pour la digestion
시럽	sirop
유자차	thé au citron
생강차, 인삼차	thé au gingembre
진찰 (診察)	consultation (médecin)
치료 (治療)	traitement
(손에) 약을 바르다	appliquer un médicament
전문의 (專門醫)	médecin spécialiste
스프레이를 뿌리다	pulvériser un spray
항생제를 먹다 (抗生劑)	prendre un antibiotique
효과 (效果)	effet
무릎	genou
주의	attention, prudence
식은 땀	sueur froide
몸살	courbatures (maladie)
입에 쓴 약이 몸에 좋다	les médicaments amers sont bons pour le corps (expr)
습관 (習慣)	habitude
고치다	corriger
담배를 끊다	arrêter de fumer
환영	bienvenue
부활절	pâques
말하기 대회	concours de discours
논	rizière
밭	 champ
영혼	âme
일몰/일출	lever / coucher du soleil
해가 지다/뜨다	le soleil se couche / lève
모으다	réunir des choses, personnes
초대장	carte d'invitation
장식하다	décorer
풍선	ballon
의미	sens, signification
서두르다	se dépêcher
부하	titre pour les subalternes
단합 모임	réunion de cohésion
채육대회	rencontre sportive
탁구	ping pong
족구	tennis joué au pied
활쏘기	tir à l'arc
영기하다	être reporté
단체	organisation
팔싸름	bras de fer
풍선을 터뜨리다	éclater, exploser un ballon
생신	anniversaire (hon.)
과일주	alcool de fruits
회비	frais de réunion (participation)
속담 (俗談)	proverbe
바쁠수록 건강을 잘 챙겨야해요/지켜야해요	plus on est occupé, plus il faut prendre soin de sa santé
도서관 사서	bibliothécaire
직장을 하다	chercher un travail
시외	banlieue
분야 / 쪽	domaine, branche
대요/내요/재요/래요/+ㅣ요	terminaison de citation
별거 안이에요	ce n'est pas grand chose
천만에요	de rien
다시 말씀해 달라고 했어요	j'ai demandé de répéter (pour moi)
다시 친구한테 말씀해 주라고 했어요	j'ai demandé de répéter (pour autrui)
R-다고/라고 할수 있어요	on peut dire que...
울리다	faire pleurer
부러워하다	envier
띠	signe de l'année de naissance / bandeau
온돌 (溫突·溫契)	système de chauffage par le sol
깔다	étaler, installer
출신지	lieu de naissance, ~home
별자리	signe du zodiaque
혈액형 (血液型)	groupe sanguin
손금	lignes de la main
운명 (運命)	destin
궁합 (宮合)	compatibilité
전시회, 박람회	exposition, foire
투표 하다	voter
바람을 쐬다	prendre le vent
돗자리	natte (ex. pique nique)
 깜짝	surprise
반 모임	réunion de classe
예복 (禮服)	vêtements de cérémonie
변장 (變裝)	déguisement
도시락	boîte repas
예약을 취소 하다	annuler une réservation
동아리 / 서클	groupe, association, club, cercle
 틀림없이	sans faute
나들이	sortie, excursion
경연 대회	concours
노래를 했을 거예요	ils ont probablement chanté (supposition dans le passé)
동창회 (同窓會)	réunion d'anciens élèves / association d'anciens élèves
한옥	maison de style traditionnel
맛의도시	ville ayant une tradition culinaire
유채 꽃	fleur de colza
족보 (族譜)	arbre généalogique
좁은 문	porte étroite
증오하다 (憎惡)	haïr
미워하다	détester
반대돼다	s'opposer, être contraire
완성하다 (完成)	compléter, terminer
철도	chemin de fer
일유학	anthropologie
공공 예절	bonnes manières en public
작곡가	compositeur de musique
관광 안내원	guide touristique
친한 친구	ami proche
무역	commerce international
추측하다	supposer
조제하다	préparer des médicaments
경영학	gestion
교육학	éducation
법학	droit
수학	mathématiques
어린이집	crèche
유지원/초등학교/중학교/고등학교/대학교	maternelle/primaire/collège/lycée/université
서다	s'arrêter, être debout
돕다	aider
정답/오답	bonne/mauvaise réponse
잘 부탁 드립니다	occupez-vous bien de moi
유람선	bateau de plaisance
표현 하다	s'exprimer
카선터	garage automobile
주차장	place de parking
정비 하다	entretenir
탤런트	acteur de drama
연기하다	interpréter, jouer un rôle
연기자	interprète
인물을 검색 하다	rechercher des gens (sur internet)
출생 연도/날짜	année/date de naissance
신체 (신장=키 + 체중=몸무게)	corps (mensurations, taille et poids)
한양	ancien nom de Séoul
학력 [항녁]	parcours scolaire
관련 [괄련]	rapport, relation
관련 정보	informations en rapport avec...
전공 하다	étudier comme spécialité
모험 여행	aventure
기억하다, 기억이 나다	se souvenir
추억	souvenir (plutôt positif)
수입	import
수출하다	exporter
두 사람이 맞아요	2 personnes s'entendent bien
선을 보다	rencontre arrangée
중매 하다	arranger une rencontre
공을 가지고 놀고 있어요	ils jouent avec un ballon
주로	en principe, en général
농구	basket ball
야구	base ball
배구	volley ball
친구를 사귀다	rencontrer des amis
사람들과 어울리다	bien aller avec quelqu'un / fréquenter quelqu'un
제외하다, 빼다	exclure
투수, 피처	personne qui lance la balle au base ball
포수, 캐처	personne qui reçoit la balle au base ball
X또는 Y	X ou bien Y
N-에 비해(서)	par rapport à...
사교적이다, 외향적이다	être sociable, extraverti
내성적이다 / 비사교적이다	être introverti / ne pas être sociable (-)
대학원생	étudiant à partir du master
X하고 다르게	contrairement à X
파티를 열다	organiser une fête
동사	verbe
형용사	adjectif
세제	détergent
새집	nouvelle maison
집들이	pendaison de crémaillère
휴지	papier toilette
승진	promotion
돌	Pierre / 1e anniversaire
금반지	bague en or (1e anniversaire d'un bébé)
 꽃다발	bouquet
푹 삶다	faire cuire longtemps
 등	etc
스승의 날	jour des professeurs
성년의날	jour de la majorité
보고서	rapport (doc)
다리미질	coup de fer à repasser
집안일	tâches ménagères
더럽다	être sale
 지저분 하다	être en désordre
 엄망이다	être en désordre
뒤죽박죽 이다	être sens dessus dessous
치우다	débarrasser
집안일을 하다	faire les tâches ménagères
빨래방	laverie
옷을 세탁소에 맡기다	confier, déposer des vêtements au pressing
화분에 물을 주다	arroser les plantes
쓰레기를 버리다	jeter les poubelles
아까, 조금전에	passé proche (adv)
갈다	changer (en combinaison avec un autre verbe)
새끼 고양이	chaton
terminer (transitif/intransitif)	끝내다/끝나다
발표를 하다	faire une présentation, un exposé
무리예요	c'est déraisonnable, au-dessus de mes capacités
어떻게 하지요? > 어쩌죠?	comment/que fait-on ?
대륙	continent
나흘	4 jours
닷새 / 엿새	5 jours / 6 jours
이레 / 여드레 / 아흐레	7/8/9 jours
열흘	10 jours
잊다	oublier
늦어도	au plus tard (adv)
자격증	certificat de qualification
능력	compétence, capacité
조금 있으면	bientôt
동해	mer de l'est
R-기로 하다 / R-기로 결심하다 / R-기로 결정하다 / R-기로 약속 하다	décision / résolution / décision / promesse
반도 / 한반도	péninsule / péninsule coréenne
꽤	assez
꽤잘하다	faire assez bien
제시하다	 présenter
비키다	se pousser
친척 집을 방문하다	 rendre visite à sa famille proche
밀린 일을 하다	faire le travail en retard, rattrapper
교외에 나가다	 sortir en banlieue
캠핑을 하다	faire du camping
부모님 일을 돕다	litt. aider ses parents dans le travail
봉사 활동을 하다	faire du bénévolat
실컷 잠을 자다	dormir à satiété, jusqu'à en avoir marre
정말 기대 돼요	j'attends ça avec impatience
거절 하다/승낙 하다	refuser / accepter
바람을 맞다/맞히다	poser/se faire poser un lapin
눈을 흘리다	pleurer
퍼센트, 프로	pourcent
7일 이상/7일 이하	7 jours et plus/ou moins
주어지다	être donné
설문 조사 / 설문 대상	enquête / personnes ciblées
기타	autres
직장인	personne qui travaille
물론	bien sur
N-(으)로 떠나다	partir pour N
N-을/를 떠나다	quitter N
속담	proverbe
품질/질	qualité d'un produit
디자인	design
베이지색	beige clair
말다	s'arrêter
투피스	tailleur 2 pièces (->femme)
설렁탕	 bouillon d'os de boeuf
탈의실	cabine d'essayage
요즘 유행하는 거예요	c'est à la mode en ce moment
유행하다	être à la mode
화려하다	être splendide, somptueux
꽉 끼다	la taille est un peu serrée
마음에 들다	plaire
세련되다/촌스럽다	être raffiné/campagnard
판단	jugement
수선하다	retoucher, ajuster un vêtement
생각보다	par rapport à ce que je pensais
헐렁하다	taille trop grande (vêtements)
두툼하다 / 두툼한 외투	épais, gonflé / doudoune
성인 / 만성절	Saint / toussaint
묘지	cimetière
큰일 났네요	c'est un grand problème
 비를 맞다	recevoir de la pluie directement, sans parapluie
망설이다	hésiter
면접시험	entretien d'embauche
구매하다	acheter
포함	inclus
상품 번호	numéro de référence produit
판매가 (<가격)	prix de vente
회원 할인가	 prix de vente pour les membres
장바구니	panier de courses
선택 사항	options d'un article (couleur, ...)
관심 상품	produit intéressant
민박	guest house
하숙	boarding house
해돋이를 보다	regarder le lever de soleil
구입 하다 (購入)	acheter
기념 촬영을 하다 (記念·紀念 / 撮影)	tourner une vidéo souvenir
해양 스포츠를 즐기다 (海洋)	faire un sport nautique (avec plaisir)
해가 뜨다 / 뜨다	le soleil se lève / flotter
결혼 기념일	anniversaire de mariage
거품	mousse
덜덜 떨다	trembler de froid
금지	interdiction
유효 기간 (有效期間)	période de validité
추천서	lettre de recommandation
이력서	CV
자기소개서	lettre de présentation
가능하다/불가능하다	être possible / impossible
운전면허증	permis de conduire
 가방에 싼 옷	vêtements emballés et mis dans une valise
자전거 핸들을 안 잡고...	sans tenir le guidon du vélo...
 떠들다	parler fort
도움이 되다	aider, être utile
야외 온천장	station thermale
얼음 낚시	pêche sous la glace
얼다	geler
중복 응답 (重複 應答)	plusieurs réponses possibles 
양로원	maison de retraite
박문관 작원	employé de musée
공공 장소	lieu public
담배를 피다	fumer une cigarette
잔디밭에 들어가다	 entrer sur la pelouse
음식을 가지고 들어가다	emporter, introduire de la nourriture
음악을 크게 틀다	allumer un appareil qui diffuse de la musique
큰 소리로 떠들다	parler fort
음식을 시켜 먹다	commander de la nourriture
이웃에게 불편주다	incommoder ses voisins
손님을 데려오다	amener des invités
애완물을 기르다	élever des animaux de compagnie
전원을 끄다	éteindre la source de courant
금연	interdit de fumer
흡연 하다	fumer
흡연실	fumoir
주의 하다	faire attention
주차 금지	interdiction de stationner
머리를/수염을 길게 기르다	laisser pousser ses cheveux/sa moustache
경비	garde, surveillant
수위	gardien (ex. résidence)
여쭤보다	demander (honorifie la personne interrogée)
이전/이후	avant/après (inclusif)
허락, 허용	permission, autorisation
심하다 (ex. 된장, 청국장)	être fort (nourriture)
그릇	vaisselle
고아원	orphelin
정리/정돈이 잘되다	être bien rangé
완두콩	petit pois
껌을 씹다	mâcher un chewing-gum
 다리를 꼬고 앉다	s'asseoir les jambes croisées
칠주의	attention à la peinture fraîche
접근금지	accès interdit
주의 사항	points auxquels faire attention
 휴게실	salle de repos
습관	habitude
습관을 바꾸다	changer ses habitudes
"""세 살 버릇 여등까지 간다"""	proverbe - ~chassez le naturel, il revient au galop
물을 마시는 습관을 가지고 있어요	avoir l'habitude de boire de l'eau
평소	habituellement
 식사를 규칙적으로 하다	manger régulièrement
자세를 바르게 하다	avoir une posture droite, correcte
크게 웃다	rire bruyamment
계단을 이용하다	utiliser les escaliers
규칙	règle
노력	effort
할 일을 미루다	procrastiner
약속에 늦다	être en retard à un rendez-vous
군덧질을 하다	grignoter entre les repas
단것을 많이 먹다	manger beaucoup de choses sucrées
과식을 하다	manger avec excès
손을 안 씻다	ne pas se laver les mains
생선회	poisson cru / sashimi
인심이 좋다/박하다	être généreux / ne pas l'être
이를 닦다	se laver les dents
간직 하다	conserver
머리를 감다	se laver les cheveux
눈을 감다/뜨다	fermer/ouvrir les yeux
고민이다 (苦悶)	être angoissant
걱정이다	être inquiétant
숫자를 세다	compter
화투	jeu de cartes coréen
소식 하다/과식 하다	manger un peu / trop
가볍게	légèrement
충분 하다	être suffisant
약속을 잘 지키다	tenir sa parole
자세	posture
반창고	pansement
일기책	journal intime
둥글다/동글다	être rond
잠그다	fermer à clef
상태	état
묘사	description
분명히	clairement
그대로	tel quel, intact
신발 끈을 묶다	nouer les lacets
땅	sol, terre
장사 /장사 하다	(petit) commerce / faire du commerce
붙다	coller, s'attacher (intransitif)
뚜껑	couvercle
서류 봉투/편지 봉투	enveloppe à documents / à lettres
건설회사	entreprise de construction
되돌려 주다	rendre qqch à qn
전하다	transmettre
감탄	étonnement
놀람	étonnement
짧은/반 소매의 와이셔츠	une chemise blanche à manches courtes
저고리	veste
무덥다	faire lourd et humide
습기가 많다	être humide
기온이 높다/낮다	la température est élevée / basse
건조하다	être sec (temps)
구름이 끼다	il y a beaucoup de nuages
서늘하다	faire froid
불쾌지수	indice d'inconfort (température, humidité)
<br>상쾌하다	être agréable
습하다	être humide
습도가 높다/낮다	le degré d'humidité est élevé / faible
이/가 하고싶다	vouloir, manquer de (+ psychologique)
비가 그치다	la pluie s'arrête de tomber
햇빛이 강하다/약하다	le soleil est fort (tape)/faible
천둥이 치다	le tonnerre frappe (bruit)
번개가 치다	l'éclair s'abat (lumière)
태풍이 오다	le typhon vient
소나기가 내리다	l'averse tombe
벼락	foudre
푹풍(우) (푹風雨)	violent/vent/(pluie) ouragan
빛	lumière, rayon
잠을 깨다	"réveiller, ""casser le sommeil"""
밤새	toute la nuit
방금	tout à l'heure, il y a peu de temps
바람이 세게 불어요	le vent souffle fort
양산 (陽傘/量産)	ombrelle / production de masse
책을 반납하다 (返納)	rendre un livre
우편물을 받다 (郵便物)	recevoir du courrier
짐을/가구를 옮기다	transporter, déplacer des valises/meubles
서류를/편지를 전하다	transmettre des documents/lettres
쉬운 말로 설명하다	expliquer avec des mots simples
엽서	carte postale
상황	situation
팔을/다리를 다치다	se blesser le bras/la jambe
혼자 하기 힘들다	c'est difficile à faire tout seul
아끼다	économiser
어떻게 하는지 모르다	ne pas savoir faire
갑자기 일이 생기다	avoir soudainement un problème
인터넷이 잘 안 되다	internet ne marche pas bien
사용 방법을 잘 모르다	ne pas savoir comment utiliser
R-았으면/었으면//면 좋겠다	expression du souhait (+ fort//-)
R-(으)ㄴ지 N(temps) 되다	temps passé depuis R
조건	condition
지은 지 얼마 안 되다	la construction est récente
주변에 편의 시설이 많다/적다	les équipements/installations dans le quartier sont nombreuses/peu nombreuses
동네가 조용하다/시끄럽다	le quartier est calme/bruyant
버스 정류장에서 가깝다/멀다	l'arrêt de bus est proche/éloigné
방이 밝다/어둡다	la chambre est lumineuse/sombre
마당이 있다/없다	il y a/n'y a pas de cour
방이 넓다/좁다	la chambre est spacieuse/petite
시설이 좋다/나쁘다	les équipements sont bons/mauvais
전기	électricité
난방 시스템	système de chauffage
각오	résolution ferme
재능이/소질이 있다	avoir un don, un talent
흥미가 있다	avoir de l'intérêt
경험이 있다	avoir de l'expérience
 보람을 느끼다	ressentir de la satisfaction
최선을 다하다	faire au mieux
포기하지 않다	ne pas abandonner
일기예보 (日氣豫報)	prévision météo
체감 온도	température ressentie
우기 (雨期)	période de pluie
우비 (雨備)	imperméable
겉옷	vêtement extérieur
택배 (宅配)	livraison à domicile
한턱 내다	payer une tournée
언제든지	n'importe quand
옷맵시	habillement
끝말 잇기	reprendre la parole
두통	mal de tête
안개	brouillard
외교관	diplomate
꽃을 키우다	faire pousser des fleurs
부동산	bien immobilier
부동산 중개 사무소	agence immobilière
암벽타기	escalade
등산	promenade en montagne
연립 주택, 빌라	maison divisée en appartements
단독 주택/공동 주택	maison individuelle (séparée) / habitation collective
전원 주택	maison en banlieue
위생시설 (衛生施設)	installations sanitaires
방음 시설	insonorisation
바람이 잘 통하다	le vent circule bien, bien aéré
욕실	salle de bains
활기천 동네, 활력있는 동네 (活力)	quartier animé
부동산 회사	société immobilière
이십대, 삼십대	la vingtaine, la trentaine
빌다	prier
보름	pleine lune
정월	1e pleine lune (1e mois de l'année lunaire)
 부럼	cacahouètes, noix, noisette
호두	noix
견과류	fruit dur
붕어빵	gauffre fourrée au haricot rouge
적성에 맞다	convenir à ses compétences, capacités
꿈을 이루다	réaliser un rêve
바람 피다	tromper son conjoint
바람둥이	coureur de jupons
잠옷 바람으로	en portant des vêtements de nuit, très légers
거칠다	être rude, grossier
꿈틀거리다	se tortiller
꺾이다	être cassé, plié, tordu
초라하다	être miteux
수수께끼	énigme
향긋하다	sentir bon
간이역	petite gare
뭉게구름	nuage épais, cumulus
모험가	aventurier
귀신	fantôme
거지	sdf
굳다	durcir (pain, terre, résolution)
슬무원	équipage (avion, bateau)
장애인	handicapé
도난당하다	se faire voler
보험	assurance
훔치다	voler
정신없이 지내다	être très occupé
성격, 성질, 성품	caractère
명품	produit de luxe
일물 묘사	description des personnes
믿음적 하다	etre digne de confiance
책임감 하다	avoir le sens des responsabilités
믿을 만하다	être digne de confiance
머리가 좋다	être intelligent
성실하다 (誠實)	être sincère, sérieux
글끼	écriture
보이다	être vu, se voir (passif) / faire voir (causatif)
지겹다	en avoir marre/être fastidieux
스트레스가 쌓이다	être stressé
스트레스를 풀다 / 스트레스가 풀리다	se débarrasser du stress
공무원	fonctionnaire
 대중/대중가요	de masse / chanson populaire
뽑다	choisir, arracher
대통령을 뽑다	choisir un président
이를 뽑다	arracher une dent
비핵화 (非核化)	dénucléarisation
흰 비둘기	colombe blanche
검토하다 (檢討)	vérifier, examiner (les faits)
복사기	photocopieur
"""눈코뜰새 없이 바빠요"""	être très occupé (expr)
아이들을 돌보다	garder, s'occuper des enfants
근대화 [近代化]	modernisation
일상 생활	vie quotidienne
찍다	tremper
녹색 고추, 풋고추	piment vert, jeune
외국에서 생활하다	vivre à l'étranger
외국에서 근무하다	travailler à l'étranger
외국계 회사에 취직하다	travailler dans une filiale d'une société étrangère
어학연수를 가다	partir pour un stage linguistique
외국 대학에 입학하다	entrer dans une université étrangère
유학하다	étudier à l'étranger
이민을 가다	émigrer
고향으로 돌아가다	retourner dans sa ville natale
귀국 하다	retourner dans son pays
광부	mineur (travaille dans une mine)
정도	environ, à peu près / niveau
한국어 실력이 어느 정도 돼요?	quel est votre niveau de coréen?
적응 하다	s'adapter, être adapté
N-에 익숙하다	être habitué à
R-(으)ㄴ 지 N-temps 되다/지나다/흐르다/넘다	expression du temps passé depuis N
시간 참 빠르네요	le temps passe vite
거의 다	presque tout
아직 멀었어요	j'en suis loin
마지막으로 연락하다	contacter pour la dernière fois
얼마 안 됐어요, 오래 안 됐어요	ça ne fait pas longtemps
오래 됐어요	ça fait longtemps
느낌	sentiment
긴장 하다	être tendu, nerveux
낯설다	être étranger, peu familier
낯	visage (peu courant)
R-게 되다 (V action)	être amené à, expression d'un changement
못 가게 됬어요	je suis, j'ai été amené à ne pas y aller (peut être pas encore realisé)
얼마 전에	il y a quelque temps
지하철 반대로 타요	prendre le métro dans le mauvais sens
1위	1e position, 1e rang
이래(서) < 이렇다	parce que, à cause de ça
점	point
우정	amitié
영원하다	être éternel
부정적 이다/긍정적 이다 (否定的/肯定的)	être negatif/positif
통하다	communiquer, circuler
여유있게	avec du temps libre
글쓴이	personne qui a écrit le texte
게시 하다	afficher
모임을 가지다	avoir une réunion
식사를 함께 하다	préparer le repas
음식을 대접하다	servir de la nourriture pour accueillir les invités
(으)ㄹ까 하다	exprime l'intention de faire qqch, incertaine
중고	occasion, seconde main
가구	meuble
초대해 줘서 고마워요	merci de m'avoir invité
꼭 갈게요/참석 할게요	je viendrai quoi qu'il arrive
일이 많아서 참석하기 어려워요	comme j'ai beaucoup de travail, ce sera difficile de participer
일정 확인해 보고 다시 연락드릴게요	je vais vérifier mon agenda et vous contacter
바쁘실 텐데 와 주셔서 감사해요	bien que vous soyez occupé, je vous remercie d'être venu
터 (dans 텐데)	lieu, chose
아쉽지만 어쩔수 없네요	c'est dommage, mais il n'y a pas d'autre solution
가까운 분들	des gens proches (fig)
R-하는 거예요 ?	"construction de soulignement, ""c'est vrai que...?"""
정성껏	avec beaucoup de soin (adv)
마음껏	à volonté, avec beaucoup de coeur
싱경을 쓰다	être attentif, s'occuper de quelque chose
여러가지	de différentes sortes, varié
경우 / 경우에는	cas / au cas où
건강을 유지하다	conserver, maintenir une bonne santé
나쁜 습관을 고치다	corriger les mauvaises habitudes
좋은 성적을 받다	avoir, recevoir de bons résultats
규칙적으로 생활하다	avoir une vie très planifiée (~routine)
실력을 높이다	développer ses capacités
돈을 모으다	économiser de l'argent
꾸준히 운동하다	faire du sport avec assiduité
거피를 줄이다	diminuer sa consommation de café
독서를 하다	lire des livres, faire une lecture
할일을 미루지 않다	ne pas repousser les choses à faire
술을/담배를 끊다	arrêter l'alcool/la cigarette
채소를 많이 먹다	consommer beaucoup de légumes
연습하다	s'entraîner
돈을 아껴쓰다	utiliser l'argent avec parcimonie
목록	table des matières
적금 통장	livret de compte d'épargne
웬일	comment se fait-il que, quelle raison, quelle chose.
배낭여행	voyage en routard
문화생활	vie civilisée
알차다	être complet
쓸데없다	être inutile, superflu
마련하다	établir un plan, prendre des mesures
줄넘기 줄	corde à sauter
싫증	dégoût
싫증이 날 정도...	jusqu'au niveau où le dégoût est ressenti
직장	lieu de travail
드물다/흔하다	être rare / abondant
대부분	majorité, plupart
대부분의 경우	La plupart des cas
출장 요리사	cuisinier à domicile (aide)
때때로, 가끔	parfois
주거	domicile
꾸미다	décorer
두르다	entourer, ceindre
 필승 (必勝)	"""réussir absolument"""
승리하다	être victorieux
합격하다	réussir un examen
패배 (敗北)	défaite
최근	récemment
"""작심 삼일"""	une résolution ne dure que 3 jours
살을 빼다, 살이 빠지다	perdre du poids
"""마음을 먹다"""	prendre une résolution (expr)
존대 (尊待)	respect
대단하다	être formidable
체육관	salle de sport
1개 이상/이하/미만	>= 1 / <=1 / >1
미세 먼지	poussière fine
나물	légumes en plat préparé
소비량 (消費量)	quantité consommée
주류	boisson alcoolisée
수량	volume, quantité
돈을 쫓다	rechercher, pourchasser l'argent
저축	épargne
알약	pilule, comprimé
곡식의 알	graine de céréale
평균 성적	note moyenne
생활비	frais de la vie courante
건강하고 알찬, 한해를 위하여	pour une année en bonne santé et bien remplie
자연 환경 보호	protection de l'environnement naturel
착각하다	se tromper
줄을 세우다	faire la queue
새치기 하다	doubler
솜	coton
갈기	crinière
흉내를 내다	imiter
소비량	consommation
책임감이 있다	être responsable
긋다	tracer une ligne
붓다	être gonflé, verser
신경을 쓰다	être attentif (utiliser ses nerfs)
공지 사항	annonce publique
놀랍다 (adj)	être étonnant
믿음직스럽다	être digne de confiance
조상	ancêtres
R-(으)ㄹ 턴데	supposition, ~ㄹ것 같아요
인정 차별	discrimination raciale
남녀 차별	discrimination hommes femmes
지역 차별	discrimination selon les régions
세대 차이	différence générationnelle
소리를 내면서 음식을 먹다	manger bruyamment
식당에서 팁을 주다	donner un pourboire au restaurant
삼키다, 삼켜 먹다	avaler (ex. médicament)
씹다	mâcher
축의금/조의금	argent versé pour une fête / un défunt
 음식 값을 각자 내다	payer chacun son repas
선배가 후배에게 밥을 주다	un ancien paie à manger à un junior
반말을 하다/말을 놓다	tutoyer
존댓말 하다	vouvoyer
그러고 보니까	se rendre compte de quelque chose
피로연	fête après un mariage
R-도록	afin que, de sorte que ; ordre attenué
사회적 신분	rang social
교회	temple protestant
교외	banlieue
무교	sans religion
유교	confucianisme
샤마니즘	chamanisme
불교	boudhisme
기독교	christianisme
대조	contraste
어색하다	être gênant, inconfortable
홀수/쩍수	nombre impair / pair
이별	séparation
중동	moyen orient
손수건	mouchoir
미신 (迷信)	superstition
정열	passion
복경	Beijing
개인적인 질문	question personnelle
정 / 한	sentiment sympathique, chaleureux // mélancolie, regret
호기심	curiosité
삼박 사일	3 nuits, 4 jours
심지어	même, en outre
제작하다	fabriquer, produire
방편 (方便)	moyen
정책	politique, ligne de conduite
운영	administration, gestion
혜택 (惠澤)	bienfait, faveur, avantage
노선 (路線)	route, ligne, itinéraire
의무적으로	obligatoirement
휴업일	jour de fermeture (commerce)
규제	restriction
부흥기	renaissance
개통	ouverture, inauguration
말이 짧아지다	tutoyer, raccourcir la parole
이웃 나라	pays voisin
포장 하다	emballer (cadeau)
관광객	touriste
제국	empire
드디어	finalement
R-고요 (R-구요)	terminaison indiquant qu'il y a autre chose à ajouter
자세히	en détails (adv)
비녀 (婢女)	épingle à cheveux
관람 시간	heure de visite
수단	moyen
도구	instrument, véhicule de la pensée
예매하다	acheter un billet en avance
표를 교환하다	échanger un billet
발급 / 표를 발급 받다	délivrance / délivrer un billet
자동 발급기	guichet automatique
매표소	guichet (avec un employé)
관람 하루 전까지	jusqu'à un jour avant votre visite
유산	patrimoine
별도	séparé, non inclus
단체 할인	réduction pour les groupes
연기하다 / 앞당기다	retarder / avancer
무인도	ile inhabitée
무박 3일	2 nuits blanches
비행기 착륙/이륙	décollage / atterrissage
이체	virement
계좌, 구좌	compte bancaire
송금	virement international
의도, 의향	intention, volonté
만원이다	être complet (hôtel)
며칠 전에...	il y a quelques jours
등급	classement
최우 등석/우등석/일반석	meilleur siège / excellent / ordinaire
새치 머리	avec un peu de cheveux blancs
당황하다	être embarrassé
R-(으)ㄹ 뻔하다	faillir...
초과 예약	overbooking
안심 하다	être rassuré
사건	événement
우연히	par chance
우연	coïncidence
필연	chose prédestinée
속상하다	être chagriné, peiné
창피하다	être honteux
유쾌하다 != 불쾌하다	être agréable, plaisant, gai
상하다	être blessé, abimé
밤을 새우면서...	en passant une nuit blanche
구별하다	distinguer
조리법	recette de cuisine
재료	ingrédient
음식 만드는 도구	instruments de cuisine
숙주나물	haricots mungo
두유	lait de soja
얹다	mettre qqch sur qqch
도라지	campanule
홍합	moule
미나리	sorte de persil
가재	langoustine
꿩	faisan
닥나무	murier
잔 받침	support à verres
향신료	épice, pour relever le goût
파스타를 삶다	faire bouillir des pâtes
썰다	couper très fin
다듬다	couper, tailler (légumes)
다지다	hacher
날씨가 푹푹 쪄요	"le temps est chaud, ""on cuit"""
양념	assaisonnement
순서	ordre (1, 2, 3...)
껍질	peau d'un fruit
채	finement
사극	film, drama historique
왕세자	fils du roi
옥탑방	terrasse sur le toit, dernier étage
위인	les grands hommes
관객	spectateur
시청자	téléspectateur
정장	costume, tailleur
양복	costume sur mesure (peu utilisé)
잠옷	pyjama
잠바	veste, blouson
R-에다가	ainsi que (lieu, objet) / indiquer un lieu
칭찬하다 // 비판하다	complimenter // critiquer
두루마기	manteau traditionnel, porté avec 한복
웃옷	manteau, vêtement pour sortir
윗옷/아래옷	vêtement haut/bas
성향	caractéristique
개성이 있다	avoir de la personnalité, son style
뒤처지다	traîner, perdre du terrain
즐겨 입다	porter souvent un vêtement
애가 타다	être anxieux
유머 감각이 있다 (感覺)	avoir le sens de l'humour
자신감이 있다	avoir confiance en soi
예의가 바르다	être poli
따라 하다	imiter
자신감이 생기다 (自信感)	avoir confiance en soi
시간이 부족이다	il n'y a pas assez de temps
반복하다	répéter
실력이 늘다	la capacité augmente
"insistance, ~""je ne sais pas combien..."""	얼마나 R-는지/(으)ㄴ지 모르다
부정하다	nier, démentir
R-기는요	nier avec emphase / accepter modestement un compliment
부끄러움을 타다	être timide
남의 말을 잘 듣다	écouter bien les autres (positif ou négatif)
이해심이 많다	être compréhensif
고집이 세다	être têtu, obstiné
활발하다 (活潑)	être actif, vif
여유가 있다	avoir du temps
적극적이다	être actif
성격이 급다	être impatient
덤벙대다	être imprudent
꼼꼼하다	être minutieux
소극적이다	être passif
짐작 하다	supposer
흥미롭다	être intéressant
영상이 아름답다	l'image est belle (dans un film)
기억에 오래 남다	rester longtemps dans la mémoire
줄거리	synopsis